7 7
0 1 2 0 0 0 0
0 0 3 4 0 4 0
0 0 5 0 0 0 0 
0 0 6 7 0 5 0
0 0 0 0 7 6 0
0 0 3 0 0 0 0
0 0 1 2 0 0 0